20x15
32

01,01,01,01,01,01,01,01,01,01,01,01,01,01,01,01,01,01,01,01
01,01,01,01,01,01,02,02,00,00,00,00,00,00,00,00,00,00,00,01
01,01,01,01,01,01,01,02,02,00,00,00,00,00,00,00,00,00,00,01
01,01,01,01,01,01,01,01,02,02,00,00,00,00,00,00,00,00,00,01
01,01,01,01,01,01,01,01,01,02,02,02,02,02,00,00,00,00,00,01
01,01,01,01,01,01,01,01,01,01,01,01,01,01,00,02,00,00,00,01
01,01,01,01,01,01,01,01,01,01,01,01,01,01,00,02,00,00,01,01
01,01,02,01,01,01,01,01,01,01,01,01,01,01,00,02,00,00,01,01
01,02,02,02,01,01,01,01,01,01,01,01,01,01,00,02,02,00,01,01
01,00,02,00,00,01,01,01,01,01,01,01,01,00,00,00,00,00,01,01
01,00,02,00,00,01,01,01,01,01,01,01,00,00,00,00,00,00,01,01
01,02,02,02,00,01,01,01,01,01,01,01,00,00,00,00,00,00,01,01
01,02,02,02,00,00,00,00,00,00,00,00,00,00,00,00,00,00,00,01
01,00,00,00,00,00,00,00,00,00,00,00,00,00,00,00,00,00,00,01
01,01,01,01,01,01,01,01,01,01,01,01,01,01,01,01,01,01,01,01

0,0,0,0,0,0,0,0,0,0,0,0,0,0,0,0,0,0,0,0
0,0,0,0,0,0,0,0,0,0,0,0,0,0,0,0,0,0,0,0
0,0,0,0,0,0,0,0,0,0,0,0,0,0,0,0,0,0,0,0
0,0,0,p,p,p,0,0,0,0,0,0,0,0,0,0,0,0,0,0
0,0,0,p,p,p,0,0,0,0,0,0,0,0,0,0,0,0,0,0
0,0,0,p,p,p,0,0,0,0,0,0,0,0,0,0,0,0,0,0
0,0,0,p,p,p,0,0,0,0,0,0,0,0,0,0,0,0,0,0
0,0,0,0,0,0,0,0,0,0,0,0,0,0,0,0,0,0,0,0
0,0,0,0,0,0,0,0,0,0,0,0,0,0,0,0,0,0,0,0
0,0,0,0,0,0,0,0,0,0,0,0,0,0,0,0,0,0,0,0
0,0,0,0,0,0,0,0,0,0,0,0,0,0,0,0,0,0,0,0
0,0,0,0,0,0,0,0,0,0,0,0,0,0,0,0,0,0,0,0
0,0,0,0,0,0,0,0,0,0,0,0,0,0,0,0,0,0,0,0
0,0,0,0,0,0,0,0,0,0,0,0,0,0,0,0,0,0,0,0
0,0,0,0,0,0,0,0,0,0,0,0,0,0,0,0,0,0,0,0

0,0,0,0,0,0,0,0,0,0,0,0,0,0,0,0,0,0,0,0
0,0,0,0,0,0,0,0,0,0,0,0,0,0,0,0,0,0,0,0
0,0,0,0,0,0,0,0,0,0,0,0,0,0,0,0,0,0,0,0
0,0,0,0,0,0,0,0,0,0,0,0,0,0,0,0,0,0,0,0
0,0,0,0,0,0,0,0,0,0,0,0,0,0,0,0,0,0,0,0
0,0,0,0,0,0,0,0,0,0,0,0,0,0,0,0,0,0,0,0
0,0,0,0,0,0,0,0,0,0,0,0,0,0,0,0,0,0,0,0
0,0,0,0,0,0,0,0,0,0,0,0,0,0,0,0,0,0,0,0
0,0,0,0,0,0,0,0,0,0,0,0,0,0,0,0,0,0,0,0
0,0,0,0,0,0,0,0,0,0,0,0,0,0,0,0,0,0,0,0
0,0,0,0,0,0,0,0,0,0,0,0,0,0,0,0,0,0,0,0
0,0,0,0,0,0,0,0,0,0,0,0,0,0,0,0,0,0,0,0
0,0,0,0,0,0,0,0,0,0,0,0,0,0,0,0,0,0,0,0
0,0,0,0,0,0,0,0,0,0,0,0,0,0,0,0,0,0,0,0
0,0,0,0,0,0,0,0,0,0,0,0,0,0,0,0,0,0,0,0