10,8

02,02,02,02,02,02,02,02,01,01
02,01,01,01,01,01,01,01,01,01
02,01,01,01,01,01,01,01,01,01
02,01,01,02,02,01,01,01,01,01
02,01,01,02,02,02,02,01,02,02
02,01,01,01,01,01,02,02,02,02
01,01,01,01,01,01,02,02,02,02
01,01,01,02,02,02,02,02,02,02

0,0,0,0,0,0,0,0,0,0
0,p,p,0,0,0,0,0,0,0
0,p,p,0,0,0,0,0,0,0
0,p,p,0,0,0,0,0,0,0
0,0,0,0,0,0,0,0,0,0
0,0,0,0,0,0,0,0,0,0
0,0,0,0,0,0,0,0,0,0
0,0,0,0,0,0,0,0,0,0

