10x8
32

02,02,02,02,02,02,02,02,01,01
02,01,01,01,01,01,01,01,01,01
02,01,01,01,01,01,01,01,01,01
02,01,01,02,02,01,01,01,01,01
02,01,01,02,02,02,02,01,02,02
02,01,01,01,01,01,02,02,02,02
01,01,01,01,01,01,02,02,02,02
01,01,01,02,02,02,02,02,02,02

0,0,0,0,0,0,0,0,0,0
0,p,p,0,0,0,0,0,0,0
0,p,p,0,0,0,0,0,0,0
0,p,p,0,0,0,0,0,0,0
0,0,0,0,0,0,0,0,0,0
0,0,0,0,0,0,0,0,0,0
0,0,0,0,0,0,0,0,0,0
0,0,0,0,0,0,0,0,0,0

4,4,4,4,4,4,4,4,4,4
4,4,4,3,3,3,2,3,3,3
4,4,4,3,3,3,2,2,2,2
4,4,4,3,3,2,0,0,0,0
3,3,3,3,3,2,1,0,0,0
3,2,2,2,2,0,0,0,0,0
2,2,0,0,0,0,0,0,0,0
0,0,0,0,0,0,0,0,0,0

5,5,5,5,7,7,5,6,5,5
5,5,5,5,7,7,5,6,4,4
4,4,4,3,6,4,5,5,4,4
3,3,3,3,6,5,5,3,2,4
4,5,4,5,5,5,4,4,2,3
4,5,4,4,4,3,4,3,1,1
4,3,4,4,3,2,2,1,1,0
4,3,3,3,3,2,1,1,0,0

