19,10

00,00,00,00,00,00,00,00,00,00,00,00,00,00,00,00,00,00,00
00,01,01,01,01,01,01,01,01,02,01,01,01,01,01,01,01,01,00
00,01,02,02,01,01,01,01,01,02,01,01,01,01,01,02,02,01,00
00,01,02,02,01,01,01,01,01,02,01,01,01,01,01,02,02,01,00
00,01,02,02,01,01,01,01,01,02,01,01,01,01,01,02,02,01,00
00,01,02,02,01,01,01,01,01,02,01,01,01,01,01,02,02,01,00
00,01,02,02,01,01,01,01,01,02,01,01,01,01,01,02,02,01,00
00,01,02,02,01,01,01,01,01,02,01,01,01,01,01,02,02,01,00
00,01,01,01,01,01,01,01,01,02,01,01,01,01,01,01,01,01,00
00,00,00,00,00,00,00,00,00,00,00,00,00,00,00,00,00,00,00

0,0,0,0,0,0,0,0,0,0,0,0,0,0,0,0,0,0,0
0,0,0,0,0,0,0,0,0,0,0,0,0,0,0,0,0,0,0
0,0,p,p,0,0,0,0,0,0,0,0,0,0,0,0,0,0,0
0,0,p,p,0,0,0,0,0,0,0,0,0,0,0,0,0,0,0
0,0,p,p,0,0,0,0,0,0,0,0,0,0,0,0,0,0,0
0,0,p,p,0,0,0,0,0,0,0,0,0,0,0,0,0,0,0
0,0,p,p,0,0,0,0,0,0,0,0,0,0,0,0,0,0,0
0,0,p,p,0,0,0,0,0,0,0,0,0,0,0,0,0,0,0
0,0,0,0,0,0,0,0,0,0,0,0,0,0,0,0,0,0,0
0,0,0,0,0,0,0,0,0,0,0,0,0,0,0,0,0,0,0

